in desparation , i called their customer service number and was told that my warranty had expired ( 2 days old ) and that the priviledge of talking to a technician would cost me ( " have your credit card ready " ) .	##['customer service number', 'warranty', 'talking to a technician']
i got it back and my built - in webcam and built - in mic were shorting out anytime i touched the lid , ( mind you this was my means of communication with my fiance who was deployed ) but i suffered thru it and would constandly have to reset the computer to be able to use my cam and mic anytime they went out .	##['built - in webcam', 'built - in mic', 'cam', 'mic']
we have had numerous problems with vista , such as adobe flash player just quits and has to be uninstalled and then reinsalled , internet explore just quits and you lose whatever you were working on , also , the same windows update has appeared on this computer since we got it and has been updated probably 400 times , the same update .	##['vista', 'adobe flash player', 'internet explore', 'windows update', 'update']
my only issues are : 1 ) the screen / video resolution wo n't increase to a higher resolution then 1024 x 60	##['screen / video resolution', 'resolution']
though the picture , video , and music software is nowhere close to professional grade software im used to ( cs5 ) but does the job for beginner and even intermediate media designers .	##['music software', 'software', 'picture', 'video']
also , because of the size and consistancy of the laptop computer , some websites would n't even attempt to work on the computer because of browser problems .	##['size', 'consistancy']
/ awesome cooling system / much better grafics card ( ati 5870 ) / 8gb ram / led backlit screen . . .	##['cooling system', 'grafics card', 'led backlit screen .', '8gb ram']
now i had not tried to use this since the disc drive had been replaced and after taking it back to the geek squad i found out they had accidently not used the right drive when they replaced the first one , so back it went to get the correct drive .	##['disc drive', 'drive', 'drive']
the machine has a bluray player the book has no mention of it or how to connect it to your hdtv .	##['bluray player', 'book']
learning all of the keyboard shortcuts only took a few minutes to get used to as some of the shortcuts are the same on windows machines .	##['keyboard shortcuts', 'shortcuts']
the apple systems are over priced luxurys that ar n't worth what they are being charged for , this model 's specifications are far from being impressive and they only thing you get out of this is the apple name .	##['specifications', 'over priced']
externally the keys on my keyboard are falling off , after a few uses the paint is rubbing off the button below the mouse pad and where the heals of my hands sit , and the screen has a terrible glare .	##['keys', 'keyboard', 'button below the mouse pad', 'screen', 'paint']
the acer one computer that i bought is 17 ince screen and its hard to find lap top bags for it , but i like the big screen on it .	##['17 ince screen', 'screen']
we also use paralles so we can run virtual machines of windows xp professional , windows 7 home premium , windows server enterprise 2003 , and windows server 2008 enterprise .	##['paralles', 'windows xp professional', 'windows 7 home premium', 'windows server enterprise 2003', 'windows server 2008 enterprise']
other than not being a fan of click pads ( industry standard these days ) and the lousy internal speakers , it 's hard for me to find things about this notebook i do n't like , especially considering the $350 price tag .	##['internal speakers', 'price tag', 'click pads']
i am pleased with the fast log on , speedy wifi connection and the long battery life ( >6 hrs ) .	##['log on', 'wifi connection', 'battery life']
everything is so easy and intuitive to setup or configure .	##['setup', 'configure']
it has all the expected features and more +plus a wide screen and more than roomy keyboard .	##['features', 'screen', 'keyboard']
they do n't just look good ; they deliver excellent performance .	##['look', 'performance']
i have had it over a year now with out a glitch of any kind . . i love the lit up keys and screen display . . . this thing is fast and clear as can be .	##['lit up keys', 'screen display']
from the speed to the multi touch gestures this operating system beats windows easily .	##['operating system', 'windows', 'speed', 'multi touch gestures']
i opted for the squaretrade 3 - year computer accidental protection warranty ( $1500 - 2000 ) which also support " accidents " like drops and spills that are not covered by applecare .	##['squaretrade 3 - year computer accidental protection warranty', 'applecare']
it is very easy to integrate bluetooth devices , and usb devices are recognized almost instantly .	##['integrate bluetooth devices', 'usb devices']
apple is unmatched in product quality , aesthetics , craftmanship , and customer service .	##['product quality', 'aesthetics', 'craftmanship', 'customer service']
i had the same reasons as most pc users : the price , the overbearing restrictions of osx and lack of support for games .	##['price', 'osx', 'support for games']
awesome form factor , great battery life , wonderful ux .	##['form factor', 'battery life', 'ux']
i did swap out the hard drive for a samsung 830 ssd which i highly recommend .	##['hard drive', 'samsung 830 ssd']
on start up it asks endless questions just so itune can sell you more of their products .	##['start up', 'itune']
one more thing , this mac does not come with restore disks and i am not sure if you can make them direct from the mac like you can with newer pc 's , also the charging cables are made of the same cheap material as the iphone / ipod touch cables .	##['restore disks', 'charging cables', 'material']
easy to customize setting and even create your own bookmarks .	##['customize setting', 'create your own bookmarks']
the mac mini , wireless keyboard / mouse and a hdmi cable is all i need to get some real work done .	##['wireless keyboard / mouse', 'hdmi cable']
it has all the features that we expected and the price was good , working well so far .	##['features', 'price', 'working']
it 's so quick and responsive that it makes working / surfing on a computer so much more pleasurable !	##['working', 'surfing']
i 'm using this computer for word processing , web browsing , some gaming , and i 'm learning programming .	##['word processing', 'web browsing', 'gaming', 'programming']
the only task that this computer would not be good enough for would be gaming , otherwise the integrated intel 4000 graphics work well for other tasks .	##['gaming', 'integrated intel 4000 graphics']
i use it mostly for content creation ( audio , video , photo editing ) and its reliable .	##['content creation', 'audio', 'video', 'photo editing']
the battery lasts as advertised ( give or take 15 - 20 minutes ) , and the entire user experience is very elegant .	##['battery', 'user experience']
! excelent performance , usability , presentation and time response .	##['performance', 'usability', 'presentation', 'time response']
in fact i still use many legacy programs ( appleworks , filemaker pro , quicken , photoshop etc ) !	##['legacy programs', 'appleworks', 'filemaker pro', 'quicken', 'photoshop']
unfortunately , it runs xp and microsoft is dropping support next april .	##['xp', 'support']
first off , i really do like my mbp . . . once used to the os it is pretty easy to get around , and the overall build is great . . . eg the keyboard is one of the best to type on .	##['os', 'overall build', 'keyboard']
it looks and feels solid , with a flawless finish .	##['finish', 'looks', 'feels']
then the system would many times not power down without a forced power - off .	##['system', 'power down']
it was also suffering from hardware ( keyboard ) issues , relatively slow performance and shortening battery lifetime .	##['performance', 'battery lifetime', 'hardware ( keyboard )']
apple is aware of this issue and this is either old stock or a defective design involving the intel 4000 graphics chipset .	##['intel 4000 graphics chipset', 'design']
osx mountain lion soon to upgrade to mavericks .	##['osx mountain lion', 'mavericks']
it wakes in less than a second when i open the lid .	##['lid', 'wakes']
however , it did not have any scratches , zero battery cycle count ( pretty surprised ) , and all the hardware seemed to be working perfectly .	##['battery cycle count', 'hardware']
and as for all the fancy finger swipes - - i just gave up and attached a mouse .	##['finger swipes', 'mouse']
i like coming back to mac os but this laptop is lacking in speaker quality compared to my $400 old hp laptop .	##['mac os', 'speaker quality']
it 's great for streaming video and other entertainment uses .	##['streaming video', 'entertainment uses']
its fast , easy to use and it looks great .	##['use', 'looks']
performance is much much better on the pro , especially if you install an ssd on it .	##['performance', 'ssd']
note , however , that any existing magsafe accessories you have will not work with the magsafe 2 connection .	##['magsafe accessories', 'magsafe 2 connection']
i am please with the products ease of use ; out of the box ready ; appearance and functionality .	##['use', 'appearance', 'functionality']
the sound was crappy even when you turn up the volume still the same results .	##['sound', 'volume']
fast , great screen , beautiful apps for a laptop ; priced at 1100 on the apple website ; amazon had it for 1098+ tax - plus i had a 10% off coupon from amazon - cost me 998 plus tax - 1070 - otd !	##['screen', 'apps', 'priced', 'cost']
the like new condition of the imac mc309ll / a on amazon is at $900+ level only , and it is a quad - core 2 . 5 ghz cpu ( similar to the $799 mini ) , with radeon hd 6750m 512mb graphic card ( this mini is integrated intel 4000 card ) , and it even comes with wireless apple keyboard and mouse , all put together in neat and nice package .	##['quad - core 2 . 5 ghz cpu', 'radeon hd 6750m 512mb graphic card', 'integrated intel 4000 card', 'wireless apple keyboard and mouse', 'package']
this mac does come with an extender cable and i 'm using mine right now hoping the cable will stay nice for the many years i plan on using this mac .	##['extender cable', 'cable']
i like the mini mac it was easy to setup and install , but i am learning as i go and could use a tutorial to learn how to use some of the features i was use to on the pc especially the right mouse click menu .	##['setup', 'install', 'tutorial', 'features', 'right mouse click menu']
the sd card reader is slightly recessed and upside down ( the nail slot on the card cannot be accessed ) , if this was a self ejecting slot this would not be an issue , but its not .	##['sd card reader', 'nail slot on the card', 'slot']
simple details , crafted aluminium and real glass make this laptop blow away the other plastic ridden , bulky sticker filled laptops .	##['aluminium', 'glass']
after all was said and done , i essentially used that $450 savings to buy 16gb of ram , two seagate momentus xt hybrid drives and an owc upgrade kit to install the second hard drive .	##['16gb of ram', 'seagate momentus xt hybrid drives', 'owc upgrade kit', 'hard drive']
i am replacing the hd with a micron ssd soon .	##['hd', 'micron ssd']
plus two finger clicking as a replacement for the right click button is surprisingly intuitive .	##['two finger clicking', 'right click button']
fan only comes on when you are playing a game .	##['fan', 'playing a game']
easy to install also small to leave anywhere at your bedroom also very easy to configure for adsl cable or wifi .	##['install', 'configure for adsl cable or wifi']
other ports include firewire 800 , gigabit ethernet , magsafe port , microphone jack .	##['ports', 'firewire 800', 'gigabit ethernet', 'magsafe port', 'microphone jack']
additionally , there is barely a ventilation system in the computer , and even the simple activity of watching videos let alone playing steam games causes the laptop to get very very hot , and in fact impossible to keep on lap .	##['ventilation system', 'watching videos', 'playing steam games']
now that i have upgraded to lion i am much happier about mac os and have just bought an imac for office .	##['lion', 'mac os']
i was a little worry at first because i do n't have a lot of experience with os . x and windows has always been second nature to me after many years of using windows .	##['os . x', 'windows', 'windows']
at home and the office it gets plugged into an external 24 " lcd screen , so built in screen size is not terribly important .	##['built in screen size', 'external 24 " lcd screen']
just beware no dvd slot so when i went to install software i had on cd i could n't .	##['install software', 'dvd slot']
this version of macbook pro runs on a third - generation cpu ( " ivy bridge " ) , not the latest fourth - generation haswell cpu the 2013 version has .	##['third - generation cpu ( " ivy bridge " )', 'fourth - generation haswell cpu']
put a ssd and use a 21 " led screen , this set up is silky smooth !	##['21 " led screen', 'ssd', 'set up']
i had to buy a wireless mouse to go with it , as i am old school and hate the pad , but knew that before i bought it , now it works great , need to get adjusted to the key board , as i am used to a bigger one and pounding .	##['wireless mouse', 'pad', 'works', 'key board']
when considering a mac , look at the total cost of ownership and not just the initial price tag .	##['cost of ownership', 'price tag']
this mac mini does not have a built - in mic , and it would seem that its mac os 10 . 9 does not handle external microphones properly .	##['built - in mic', 'mac os 10 . 9', 'external microphones']
air has higher resolution but the fonts are small .	##['resolution', 'fonts']
working with mac is so much easier , so many cool features .	##['working', 'features']
i like the brightness and adjustments .	##['brightness', 'adjustments']
i re - seated the " wlan " card inside and re - installed the lan device drivers .	##['" wlan " card', 'lan device drivers']
a veryimportant feature is firewire 800 which in my experience works better then usb3 ( in pc enabled with usb3 ) i was not originally sold on the mac os i felt it was inferior in many ways to windows 7 .	##['firewire 800', 'usb3', 'usb3', 'mac os', 'windows 7']
i like itunes , the apparent security , the mini form factor , all the nice graphics stuff .	##['itunes', 'security', 'mini form factor', 'graphics stuff']
the first time i used the card reader it took half an hour and a pair of tweezers to remove the card .	##['card reader', 'remove the card']
it also comes with 4g of ram but if you 're like me you want to max that out so i immediately put 8g of ram in her and i 've never used a computer that performs better .	##['4g of ram', '8g of ram', 'performs']
also . . . - excellent operating system - size and weight for optimal mobility - excellent durability of the battery - the functions provided by the trackpad is unmatched by any other brand -	##['operating system', 'size', 'weight', 'mobility', 'durability of the battery', 'functions provided by the trackpad']
screen - although some people might complain about low res which i think is ridiculous .	##['screen', 'res']
