do n't go alone - - - even two people is n't enough for the whole experience , with pickles and a selection of meats and seafoods .	##['pickles', 'selection of meats and seafoods']
three courses - choices include excellent mussels , puff pastry goat cheese and salad with a delicious dressing , and a hanger steak au poivre that is out of this world .	##['mussels', 'puff pastry goat cheese', 'salad with a delicious dressing', 'hanger steak au poivre', 'courses']
the place is so cool and the service is prompt and curtious .	##['service', 'place']
i also recommend the rice dishes or the different varieties of congee ( rice porridge ) .	##['rice dishes', 'congee ( rice porridge )']
the fish is fresh but the variety of fish is nothing out of ordinary .	##['fish', 'variety of fish']
the soup for the udon was soy sauce and water .	##['soup for the udon', 'soy sauce', 'water']
we are very particular about sushi and were both please with every choice which included : ceviche mix ( special ) , crab dumplings , assorted sashimi , sushi and rolls , two types of sake , and the banana tempura .	##['sushi', 'ceviche mix ( special )', 'crab dumplings', 'assorted sashimi', 'sushi', 'rolls', 'sake', 'banana tempura']
pastrami or corned beef are juicy and piled high ( ask for extra rye bread ) .	##['pastrami or corned beef', 'rye bread']
although they do the typical what kind of water would you like questions the service was good and overall very relaxing to place to eat .	##['service', 'place', 'water']
- the bread at the beginning is super tasty and makes you want more - the pizza is delicious and comes in personal sizes , however be warned that the peter 's favourite pizza with prosciutto and baby arugula is actually a margarite pizza with cold prosciutto and baby arugula on top , like a salad .	##['bread', 'pizza', 'margarite pizza with cold prosciutto and baby arugula on top', 'salad', "peter 's favourite pizza with prosciutto and baby arugula"]
whenever you need a sushi fix , mizu will be there with quality fish and great service .	##['fish', 'service', 'sushi fix']
first the wrong bread came out with the appetizer , then when i tried to order a second glass of wine for my main course . . .	##['bread', 'appetizer', 'glass of wine', 'main course']
there was a long wait for a table outside , but it was a little too hot in the sun anyway so our insde table was very nice .	##['table', 'insde table', 'wait']
given the incredible architecture surrounding it , this place has no character .	##['architecture', 'place']
this place , however , has a lot less pretension than joya and the thai food is still above - average .	##['place', 'thai food']
the back garden sitting area is very pleasant , where you can see their personal herb garden .	##['back garden sitting area', 'personal herb garden']
the pad thai , lad nar and various other dishes all look good on paper but , i 've had better thai food in less asthetically pleasing places .	##['pad thai', 'lad nar', 'dishes', 'places', 'thai food']
my picks : guizhou chicken , fish with hot bean source , fish fillet in spicy source ( special menu ) .	##['guizhou chicken', 'fish with hot bean source', 'fish fillet in spicy source', 'special menu']
the singapore mai fun had no curry flavor whatsoever .	##['singapore mai fun', 'curry flavor']
the menu seemed to have a wide variety of dishes for seafood lovers and interesting ways of preparing them .	##['menu', 'variety of dishes', 'seafood']
great food , great lay out and awesome service .	##['food', 'lay out', 'service']
ive asked a cart attendant for a lotus leaf wrapped rice and she replied back rice and just walked away .	##['cart attendant', 'lotus leaf wrapped rice', 'rice']
this place has the best interior i have seen anywhere in the northside of w'burg , and will impress whoever you bring there .	##['interior', 'place']
after complaining about the chicken dish , the manager came over to tell us that , no one had ever complained before , and that we just did n't know what the dish was supposed to taste like .	##['chicken dish', 'manager', 'dish']
fluke sashimi drizzled with jalapeno - lime olive oil , the fruit of the oil nicely highlighting the fish 's sweetness .	##['fluke sashimi', 'jalapeno - lime olive oil', 'fruit of the oil', 'fish']
although be warned their dinner menu to sit and take out prices are different .	##['prices', 'dinner menu to sit', 'take out']
the one vegetarian entree ( abby 's treasure ) was actually quite a surprise - it was delicious and had wintermelon covering an assortment of fresh mushrooms and vegetables .	##['vegetarian entree', "abby 's treasure", 'wintermelon', 'assortment of fresh mushrooms and vegetables']
service was decent , but not as smooth as i would expect from a place with these prices and reputation .	##['service', 'prices', 'reputation']
great food ( spinach and corn dumplings and massamman curry ) , very friendly and no nonsense service and a clean and funky bathroom .	##['food', 'spinach and corn dumplings', 'service', 'bathroom', 'massamman curry']
sometimes i get bad food and bad service , sometimes i get good good and bad service .	##['food', 'service', 'service', 'good']
if you love seafood , you would love this place !	##['seafood', 'place']
but they 've done a really nice job of offering all the typical pizzeria faves plus some terrific specials like the godmother pizza ( a sort of traditional flat pizza with an olive oil - brushed crust and less tomato sauce than usual ) .	##['godmother pizza ( a sort of traditional flat pizza with an olive oil - brushed crust and less tomato sauce than usual )', 'specials']
leon is an east village gem : casual but hip , with well prepared basic french bistro fare , good specials , a warm and lively atmosphere .	##['specials', 'atmosphere', 'french bistro fare']
this place has good potential , but needs a significant amount of work before we can justify spending that much money on indian food you can get everywhere else .	##['money', 'indian food']
the menu prices are a bit expensive for what you get in quality and portion size .	##['menu prices', 'quality', 'portion size']
in such a crappy part of town to find a good value for lunch , this place is great .	##['value', 'lunch']
unless you are eating in the pizzeria side of this place , and are not in a rush , this place is a bad idea .	##['place', 'place']
from the complimentary chef app of a delicate butternut squash ravioli in a delicious truffle sauce to an amazing buttery and tender langostine entree to a dessert that i ca n't remember because of the fabulous cakebread cabernet we were drinking - - the whole evening was amazing .	##['chef app', 'delicate butternut squash ravioli in a delicious truffle sauce', 'buttery and tender langostine entree', 'dessert', 'cakebread cabernet']
we ended our great experience by having gulab jamun ( dessert ) recommended by the waiter .	##['gulab jamun ( dessert )', 'waiter']
stick to dimsum , not super overpriced noodles .	##['noodles', 'dimsum']
this place has the the correct ambience and an excellent staff to make you feel like a guest and a friend at the same time .	##['place', 'ambience', 'staff']
aside from the sea urchin , the chef recommended an assortment of fish including fatty yellow tail , boton shrimp , blue fin torro ( fatty tuna ) , sea eel , etc .	##['chef', 'assortment of fish', 'fatty yellow tail', 'boton shrimp', 'sea eel', 'sea urchin', 'blue fin torro ( fatty tuna )']
good atmosphere , combination of all the hottest music dress code is relatively strict except on fridays .	##['atmosphere', 'music', 'dress code']
i would recommend putting your name down and then getting a drink at a local bar first though because of the wait time .	##['drink', 'bar', 'wait time']
while most people can attest to spending over $50 on drinks in new york bars and hardly feeling a thing , the drinks here are plentiful and unique .	##['drinks', 'bars', 'drinks']
best spicy tuna roll , great asian salad .	##['asian salad', 'spicy tuna roll']
try the rose roll ( not on menu ) .	##['rose roll', 'menu']
anytime and everytime i find myself in the neighborhood i will go to sushi rose for fresh sushi and great portions all at a reasonable price .	##['sushi', 'portions', 'price']
from the beginning , we were met by friendly staff memebers , and the convienent parking at chelsea piers made it easy for us to get to the boat .	##['staff memebers', 'parking']
desserts are almost incredible : my personal favorite is their tart of the day .	##['desserts', 'tart of the day']
had a great experience at trio . . . staff was pleasant ; food was tasty and large in portion size - i would highly recommend the portobello / gorgonzola / sausage appetizer and the lobster risotto .	##['staff', 'food', 'portion size', 'portobello / gorgonzola / sausage appetizer', 'lobster risotto']
try the peanut butter sorbet and the pizza with soy cheese !	##['peanut butter sorbet', 'pizza with soy cheese']
the food is great ( big selection , reasonable prices ) and the drinks are really good .	##['food', 'selection', 'prices', 'drinks']
the selection of food is excellent ( i 'm not used to having much choice at restaurants ) , and the atmosphere is great .	##['selection of food', 'atmosphere']
only suggestion is that you skip the dessert , it was overpriced and fell short on taste .	##['dessert', 'taste']
the food was very good and i was pleasantly surprised to see so many vegan options .	##['food', 'vegan options']
montparnasse 's desserts - - especially the silken creme brulee and paper - thin apple tart - - are good enough on their own to make the restaurant worth the trip .	##['desserts', 'creme brulee', 'apple tart']
try the ribs , sizzling beef and couple it with coconut rice .	##['coconut rice', 'ribs', 'beef']
the food was great - sushi was good , but the cooked food amazed us .	##['food', 'sushi', 'cooked food']
for the price you pay for the food here , you 'd expect it to be at least on par with other japanese restaurants .	##['price', 'food']
my favs here are the tacos pastor and the tostada de tinga . . .	##['tacos pastor', 'tostada de tinga']
for a savory take on the soup and sandwich meal , try the hot and sour soup .	##['hot and sour soup', 'soup and sandwich meal']
in addition to great hot dogs , dotp has wonderful breakfast sandwiches that feature , in addition to great things like tator tots and english muffins , a delicious nj - based pork product know to us jersey girls and boys as taylor ham .	##['hot dogs', 'breakfast sandwiches', 'tator tots', 'english muffins', 'taylor ham', 'pork product']
well , it happened because of a graceless manager and a rude bartender who had us waiting 20 minutes for drinks , and then tells us to chill out .	##['manager', 'bartender', 'drinks', 'waiting']
it 's about $7 for lunch and they have take - out or dine - in .	##['lunch', 'take - out', 'dine - in']
be sure to accompany your food with one of their fresh juice concoctions .	##['food', 'fresh juice concoctions']
they have a very good chicken with avocado and good tuna as well .	##['chicken with avocado', 'tuna']
the unattractive lighting made me want to gag , the food was overpriced , there was the most awful disco pop duo performing - and my escargot looked like it might crawl off the plate .	##['lighting', 'food', 'disco pop duo', 'escargot']
dieters stick to salads or indulge in vegetarian platters .	##['salads', 'vegetarian platters']
the host ( owner ) and servers are personable and caring .	##['host ( owner )', 'servers']
the skillfully chosen portuguese cheese cart paired with quality port provides the perfect iberian ending .	##['port', 'portuguese cheese cart']
first walking in the place seemed to have great ambience .	##['place', 'ambience']
half a chicken with a mountain of rice and beans for $6 . 25 .	##['rice', 'beans', 'chicken']
casablanca servces delicious falafel , tabouleh , humus and other mediterranean delights , which are all very inexpensive .	##['falafel', 'tabouleh', 'humus', 'mediterranean delights']
the banana pudding they serve has never seen an oven , the crabcakes are way over salted and do n't get me started on the very greasy mac and cheese .	##['banana pudding', 'crabcakes', 'mac and cheese']
they have homemade pastas of all kinds - - i recommend the gnocchi - - yum !	##['homemade pastas', 'gnocchi']
my vegetable risotto was burnt , and infused totally in a burnt flavor .	##['vegetable risotto', 'flavor']
best things to order are from the grill ( churrasco and ribs ) .	##['grill', 'churrasco', 'ribs']
the traditional italian items are great - cheap and served in a cozy setting .	##['traditional italian items', 'setting', 'served']
our waitress had apparently never tried any of the food , and there was no one to recommend any wine .	##['waitress', 'food', 'wine']
the unfortunate lady next to us thought she had ordered a salad ( including asking for salad dressing ) and was instead given a quesedilla .	##['salad', 'salad dressing', 'quesedilla']
the service was pretty poor all around , the food was well below average relative to the cost , and outside there is a crazy bum who harasses every customer who leaves the place .	##['service', 'food', 'cost']
you must try odessa stew or rabbit stew ; salads - all good ; and kompot is soo refreshing during the hot summer day ( they make it the way my mom does , reminds me of home a lot ) .	##['odessa stew', 'rabbit stew', 'salads', 'kompot']
they specialize in smoothies and fresh juices .	##['smoothies', 'fresh juices']
in mi burrito , here was nothing but dark chicken that had that cooked last week and just warmed up in a microwave taste .	##['taste', 'chicken']
from the erbazzone emiliana to the mostarda on the cheese plate , the dishes at this restaurant are all handled with delicate care .	##['erbazzone emiliana', 'mostarda on the cheese plate', 'dishes']
there 's candlelight and music .	##['candlelight', 'music']
the place is absolutely adorable and the food is delicious .	##['place', 'food']
the staff members are extremely friendly and even replaced my drink once when i dropped it outside .	##['staff members', 'drink']
the sashimi portion are big enough to appease most people , but i did n't like the fact they used artifical lobster meat .	##['sashimi portion', 'artifical lobster meat']
speedy delivers , great food , decent prices , and friendly service combine to ensure an enjoyable repast .	##['delivers', 'food', 'prices', 'service', 'repast']
generously garnished , organic grilled burgers are the most popular dish , but the jerusalem market - style falafel wraps and mediterranean salads - - layered with beets , goat cheese and walnuts - - are equally scrumptious .	##['organic grilled burgers', 'dish', 'jerusalem market - style falafel wraps', 'mediterranean salads - - layered with beets , goat cheese and walnuts']
probably my worst dining experience in new york , and i 'm a former waiter so i know what i 'm talking about .	##['dining experience', 'waiter']
result ( red velvet ) : great texture , soft and velvety , nice hint of cocoa .	##['texture', 'hint of cocoa']
i love the little pie company as much as anyone else who has written reviews , but must discourage anyone from visiting the grand central location due to their rude service from two sales people .	##['service', 'sales people']
the other times i 've gone it 's romantic date heaven , you can walk in get a booth by the windows , be treated like a vip in a not - crowded place , with great food and service .	##['booth by the windows', 'place', 'food', 'service']
somewhat disappointing wine list ( only new vintages .	##['wine list', 'vintages']
new hamburger with special sauce is ok - at least better than big mac !	##['new hamburger with special sauce', 'big mac']
my only complaint might be the fortune cookies - i 've never had a cookie predict bad luck for me before i visited kar .	##['fortune cookies', 'cookie']
have a mojito and sit in the back patio .	##['mojito', 'back patio']
the waitress came by to pick up the soy sauce while we were eating our lunch ! ! ! ! !	##['waitress', 'soy sauce', 'lunch']
they also have a great assortment of wraps if your not in the mood for traditional mediterranean fare .	##['assortment of wraps', 'traditional mediterranean fare']
fresh veggies , all sorts of middle eastern spreads , cheese and falafel , soup , fish , rice , root vegetables , a rice medley , some spinach thing , lamb kebabs , cheese baclava . . . soooo much fooood , and all of it delicious .	##['fresh veggies', 'middle eastern spreads', 'cheese', 'falafel', 'soup', 'fish', 'rice', 'root vegetables', 'rice medley', 'spinach thing', 'lamb kebabs', 'cheese baclava', 'fooood']
then she made a fuss about not being able to add 1 or 2 chairs on either end of the table for additional people .	##['chairs', 'table']
the happy hour is so cheap , but that does not reflect the service or the atmosphere .	##['happy hour', 'service', 'atmosphere']
after waiting for almost an hour , the waiter brusquely told us he 'd forgotten to give the kitchen our order .	##['waiter', 'kitchen', 'waiting']
with all the mundane or mediocre places on 8th avenue it is nice to have one that is a step above in quaility and atmosphere .	##['quaility', 'atmosphere']
a mix of students and area residents crowd into this narrow , barely there space for its quick , tasty treats at dirt - cheap prices .	##['space', 'prices', 'treats']
the negative reviews on city search are probably from jealous competing restaurants who realize they ca n't compete with temple 's entire positive attitude about the proper way to treat their customers and deliver top quality food .	##['food', 'attitude']
overall , this is a nice place to take a few friends to hang out at and the service is excellent .	##['place', 'service']
good service , great food , good value , and never have to wait in line !	##['service', 'food', 'value', 'wait']
offerings like hot cakes and the egg mcmuffin sandwich are available for breakfast .	##['egg mcmuffin sandwich', 'hot cakes', 'breakfast']
cuisine is billed as asian fusion - does n't meet the bill .	##['cuisine', 'bill', 'asian fusion', 'billed']
creative dishes like king crab salad with passion fruit vinaigrette and fettuccine with grilled seafood in a rosemary - orange sauce are unexpected elements on an otherwise predictable bistro menu .	##['dishes', 'king crab salad with passion fruit vinaigrette', 'fettuccine with grilled seafood in a rosemary - orange sauce', 'bistro menu']
dishes denoted as " roy 's classics " ( marked on the menu with asterisks ) are tried - and - true recipes , such as macadamia - crusted mahi mahi , or subtly sweet honey - mustard beef short ribs .	##['dishes', '" roy \'s classics "', 'menu', 'recipes', 'macadamia - crusted mahi mahi', 'sweet honey - mustard beef short ribs']
the lone argentine chorizo appetizer at $8 . 95 was a heavy fennel flavored italian sausage like the ones that sell for $2 . 99 / lb at the store .	##['argentine chorizo appetizer', 'fennel flavored italian sausage']
it has good music , nice tapas , an interesting selection of wines ( primarily spanish ) and a lowkey hip neighborhood clientele .	##['music', 'tapas', 'selection of wines ( primarily spanish )', 'clientele']
the food is great , i love their dumplings , cold sesame noodles , chicken and shrimp dishs .	##['food', 'dumplings', 'cold sesame noodles', 'chicken', 'shrimp dishs']
waiting three hours before getting our entrees was a treat as well .	##['entrees', 'waiting']
you can eat gourmet food at a fast food price .	##['price', 'food']
the dinner menu offers a variety of great entrees , including fresh seafood and huge steaks , there 's also a couple of non - meat alternatives .	##['dinner menu', 'entrees', 'seafood', 'steaks', 'non - meat alternatives']
food is excellent and they also have empenadas and plaintains which are good for an afternoon snack .	##['food', 'empenadas', 'plaintains', 'afternoon snack']
all - time favorites include the big mac , chicken mcnuggets , filet - o - fish sandwich and mcdonald 's famous french fries ; lighter options like entree - sized salads are also available .	##['big mac', 'chicken mcnuggets', 'filet - o - fish sandwich', "mcdonald 's famous french fries", 'entree - sized salads']
innovations are just as assured , from the simple carinthia cheese ravioli with wild mushrooms to the caviar - topped sturgeon , beautifully matched with a bright green spinach - vodka sauce .	##['carinthia cheese ravioli with wild mushrooms', 'caviar - topped sturgeon', 'green spinach - vodka sauce']
and these are not small , wimpy fast food type burgers - these are real , full sized patties .	##['burgers', 'patties']
chinatown definitely has better quality with cheaper prices .	##['quality', 'prices']
i had to flag down a third staff person for a fork . . . so now it 's goodbye little rude pie company .	##['staff person', 'fork']
definitely try the calamari , any pasta , or even the sliced steak entree .	##['calamari', 'pasta', 'sliced steak entree']
this place is classy , chic , the service is warm and hospitable , and the food is outstanding .	##['place', 'service', 'food']
the yellowfin tuna and calf 's liver are my favorites !	##['yellowfin tuna', "calf 's liver"]
they bring a sauce cart up to your table and offer you up to 7 or 8 choices of sauces for your steak ( i tried them all ) .	##['steak', 'choices of sauces', 'sauce cart', 'table']
likewise if you like really thin crust or really big slices then nick and joe 's may not be your favorite .	##['thin crust', 'slices']
build a meal with side orders like amazin' greens salads , buffalo chicken kickers and cinna stix .	##['meal', "amazin' greens salads", 'buffalo chicken kickers', 'cinna stix', 'side orders']
thick fries , meaty chili and stuffed baked potatoes round out a menu that includes a cool , ultra - thick chocolate frosty .	##['fries', 'meaty chili', 'stuffed baked potatoes', 'menu', 'chocolate frosty']
the homage to india is most evident in the delectable roti canai appetizer , a fried pancake served with pungent curry dipping sauce , while the mango chicken offers a surprisingly sophisticated , fresh take on sweet - and - sour .	##['roti canai appetizer', 'mango chicken', 'fried pancake served with pungent curry dipping sauce']
it does n't look like much on the outside , but the minute you walk inside , it 's a whole other atmosphere .	##['outside', 'atmosphere']
the ground chickpea soup we sampled as a starter tasted somewhat thin .	##['ground chickpea soup', 'starter']
the service , however , is a peg or two below the quality of food ( horrible bartenders ) , and the clientele , for the most part , are rowdy , loud - mouthed commuters ( this could explain the bad attitudes from the staff ) getting loaded for an ac / dc concert or a knicks game .	##['service', 'quality of food', 'bartenders', 'clientele', 'staff']
make more tables - perhaps a rooftop bar ?	##['tables', 'rooftop bar']
my chelsea 's impressive and creative menu includes modern , westernized japanese dishes such as foie gras unagi napolean , jap style hamburger steak , spicy cod roe spaghetti , black cod with miso base , and rack of lamb in black truffle sauce , to name a few .	##['menu', 'japanese dishes', 'foie gras unagi napolean', 'jap style hamburger steak', 'spicy cod roe spaghetti', 'black cod with miso base', 'rack of lamb in black truffle sauce']
but , the filet mignon was not very good at all cocktail hour includes free appetizers ( nice non - sushi selection ) .	##['cocktail hour', 'filet mignon', 'non - sushi selection', 'appetizers']
i was on jury duty , rode my bike up centre street on my lunch break and came across this great little place with awesome chicken tacos and hibiscus lemonade .	##['chicken tacos', 'hibiscus lemonade', 'place']
good place to hang out during the day after shopping or to grab a simple soup or classic french dish over a glass of wine .	##['place', 'soup', 'french dish', 'glass of wine']
however , there is just something so great about being outdoors , in great landscaping , enjoying a casual drink that makes going to this place worthwhile .	##['casual drink', 'outdoors', 'place']
the comments about fried foods is correct ( below ) but the other dishes , including the lamb entree and many of the salads ( avocado shrimp ) were quite good .	##['fried foods', 'dishes', 'lamb entree', 'salads ( avocado shrimp )']
the sauce is excellent ( very fresh ) with dabs of real mozzarella .	##['dabs of real mozzarella', 'sauce']
a small , outdoor eating area makes for a private , comfortable space to study alone or meet up with friends .	##['space', 'outdoor eating area']
the best dessert , a chocolate and peanut butter tart , is n't particularly hawaiian , but it 's a small world when it comes to sweets .	##['dessert', 'chocolate and peanut butter tart', 'sweets']
the room is a gorgeous , bi - level space and the long bar perfect for a drink .	##['room', 'bi - level space', 'long bar', 'drink']
the chicken and falafel platters were nondescript combinations with fresh leaf salad .	##['chicken and falafel platters', 'fresh leaf salad']
they are served on focacchia bread and are to die for .	##['served', 'focacchia bread']
the food is just okay , and it 's almost not worth going unless you 're getting the pialla , which is the only dish that 's really good .	##['food', 'pialla', 'dish']
the guac is fresh , yet lacking flavor , we like to add our fresh salsa into it .	##['guac', 'fresh salsa', 'flavor']
the new menu has a few creative items , they were smart enough to keep some of the old favorites ( but they raised the prices ) , the staff is friendly most of the time , but i must agree with the person that wrote about their favorite words : no , ca n't , sorry . . . , boy , they wo n't bend the rules for anyone .	##['prices', 'staff', 'new menu']
" the menu includes pub fare - - burgers , steaks and shepherds pie - - and even a portabella lasagna for those black sheep known as " vegetarians .	##['menu', 'burgers', 'steaks', 'shepherds pie', 'portabella lasagna', 'pub fare']
i stopped by for some brunch today and had the vegan cranberry pancakes and some rice milk .	##['brunch', 'vegan cranberry pancakes', 'rice milk']
creamy appetizers - - taramasalata , eggplant salad , and greek yogurt ( with cuccumber , dill , and garlic ) taste excellent when on warm pitas .	##['creamy appetizers', 'warm pitas', 'taramasalata', 'eggplant salad', 'greek yogurt ( with cuccumber , dill , and garlic )']
